....................
....................
....................
....................
....................
..s.................
..o........c........
...........o........
....................
.....o.........o....
.c..................
.o...........o......
....o.....c.........
..........o......c..
..o.................
..e..o.e..o...e..x..
oooooooooooooooooooo